# additional keywords for JavaScript mode
# https://developer.mozilla.org/en/JavaScript/Reference/Reserved_Words

preload	FUNCTION4

debugger	KEYWORD1
var	KEYWORD1
function	KEYWORD1
typeof	KEYWORD1
delete	KEYWORD1
throw	KEYWORD1
with	KEYWORD1
in	KEYWORD1

prototype	KEYWORD1
arguments	KEYWORD1
#callee	KEYWORD1

enum	KEYWORD1
export	KEYWORD1
let	KEYWORD1
yield	KEYWORD1
undefined	KEYWORD1
const	KEYWORD1

# some specials

console	KEYWORD1
window	KEYWORD1
document	KEYWORD1

alert	KEYWORD3

circle	FUNCTION1    circle_
square	FUNCTION1    square_
push	FUNCTION1  push_
pop	FUNCTION1   pop_
